TILEMAP
212 16 							-- Size of tile map in tiles
32 32 							-- Tile size & block size
images/tiles.png 	-- Tilesheet
20 8 								-- Number of tiles in tilesheet
O
00                                                                                                                                                                                                                  
00                                                                                                                                                                                                                  
00                                                                                                                                                                                                                  
00                                                                                                                                                                                                     D            
00                                                                                                                                                                                                     X            
00                                                                                                                                                                                                     X            
00                                                                                                                                                                                                     X            
00                                                                                                                                                                                                     X            
00                                                                                                                                                                                                     X            
00                                                                                                                                                                                                     X    555     
00                                                                                                                                                                                                     X    638     
00                                                                                                                                                                                                 j   X   5III5    
00                                                                                                                                                                                                i}k  X   37J73  j 
00                                                                                                                                                                                               i}~}k     37K73|i}k
00000000000000000000000000000000000000000000000000000000000000000000000000000000000000000000000000000000000000000000000000000000000000000000000000000000000000000000000000000000000000000000000000000000000000000000
00000000000000000000000000000000000000000000000000000000000000000000000000000000000000000000000000000000000000000000000000000000000000000000000000000000000000000000000000000000000000000000000000000000000000000000
0
